XXX
The Parking Meter
An Interactive Fiction by autowitch
Release 1 / Serial number 131202 / Inform 7 build 6G60 (I6/v6.32 lib 6/12N) SD

Endless Street
You are standing on a deserted street running to the east and the west. Old boarded up shops line the street on both sides.

You can see an a parking meter next to the street here.

>l
Endless Street
You are standing on a deserted street running to the east and the west. Old boarded up shops line the street on both sides.

You can see a parking meter here.

>take meter
Taken.

* * *

XXX
The Parking Meter
An Interactive Fiction by autowitch
Release 1 / Serial number 131202 / Inform 7 build 6G60 (I6/v6.32 lib 6/12N) SD

Endless Street
You are standing on a deserted street running to the east and the west. Old boarded up shops line the street on both sides.

You can see an a parking meter next to the street here.

>x meter
A new looking parking meter. There dial indicates that the time is expired.

* * *

XXX
The Parking Meter
An Interactive Fiction by autowitch
Release 1 / Serial number 131202 / Inform 7 build 6G60 (I6/v6.32 lib 6/12N) SD

Endless Street
You are standing on a deserted street running to the east and the west. Old boarded up shops line the street on both sides.

You can see an a parking meter next to the street here.

>e
You walk down the street for a long time and find yourself back where you started. That's odd.

>w
You walk down the street for a long time and find yourself back where you started.

>n
The shops are all boarded up.

>s
The shops are all boarded up.
 You try to peel some of the plywood off, but to no avail.

>e
You walk down the street for a long time and find yourself back where you started.

* * *

>n
The shops are all boarded up.

>n
The shops are all boarded up.

>s
The shops are all boarded up.

>se
The shops are all boarded up.

>sw
The shops are all boarded up.

>n
The shops are all boarded up.

>n
The shops are all boarded up.
You try to peel some of the plywood off, but to no avail.

* * *

>w
You walk down the street for a long time and find yourself back where you started.

>u
foo

>d
foo

>n
foo

* * *

>w
You walk down the street for a long time and find yourself back where you started.

>z
You wait for hours, but no bus comes by to pick you up.

>n
The shops are all boarded up.

>s
The shops are all boarded up.
You knock at one of the boarded up doors. There is no answer

>ne
The shops are all boarded up.

>u
There's not really anything to climb here.

>d
There's no way down. Not even a manhole.

>x street
An empty potholed street

>x potholes
Some of these potholes could swallow a Geo Metro.

>x car
You don't have a car. You came here by bus.

* * *

>e
You walk down the street for a long time and find yourself back where you started. That's odd.

>e
You walk down the street for a long time and find yourself back where you started.

>w
You walk down the street for a long time and find yourself back where you started.

>w
You walk down the street for a long time and find yourself back where you started.

* * *

>n
The shops are all boarded up.

>ne
The shops are all boarded up. You try to peel some of the plywood off, but to no avail

>u
There's not really anything to climb here.

* * *

>w
You walk down the street for a long time and find yourself back where you started.

>n
The shops are all boarded up. You knock at one of the boarded up doors. You just hear a hollow noise.

>s
The shops are all boarded up.

>s
The shops are all boarded up. You knock at one of the boarded up doors. There is no answer

* * *

>e
You walk down the street for a long time and find yourself back where you started. That's odd.

>n
The shops are all boarded up.

>s
You can't go that way.

* * *

>n
The shops are all boarded up.

>open window
They are securely boarded up.

>open windows
They are securely boarded up.

>close window
They are already about as closed as they can be.

* * *

XXX
The Parking Meter
An Interactive Fiction by autowitch
Release 1 / Serial number 131202 / Inform 7 build 6G60 (I6/v6.32 lib 6/12N) SD

Endless Street
You are standing on a deserted street running to the east and the west. Old boarded up shops line the street on both sides.

You can see an a parking meter next to the street here.

>u
foo

>d
The shops are all boarded up.

>n
The shops are all boarded up.

>e
You walk down the street for a long time and find yourself back where you started. That's odd.

* * *

XXX
The Parking Meter
An Interactive Fiction by autowitch
Release 1 / Serial number 131202 / Inform 7 build 6G60 (I6/v6.32 lib 6/12N) SD

Endless Street
You are standing on a deserted street running to the east and the west. Old boarded up shops line the street on both sides.

You can see an a parking meter next to the street here.

>n
The shops are all boarded up.

* * *

>n
The shops are all boarded up.
You try to peel some of the plywood off, but to no avail.

>n
The shops are all boarded up.

* * *

>n
The shops are all boarded up.
You try to peel some of the plywood off, but to no avail.

>u
The shops are all boarded up. .

* * *

>n
The shops are all boarded up.
You try to peel some of the plywood off, but to no avail.

>s
The shops are all boarded up.

>n
The shops are all boarded up.
You knock at one of the boarded up doors. You just hear a hollow noise.

* * *

>s
The shops are all boarded up.

>put coin in meter
Clunk. The meter now indicates 15 minutes remaining.

>n
fooAs you touch the plywood over the door, it transforms into a swarm a moths and flies off
Abandoned Shop
A simple wooden table with the word "RUBEUS" carved on it.

On the Wooden table are a left doll leg, a right doll leg, a left doll arm, a right doll arm, a doll torso and a doll head.

>s
Endless Street
You are standing on a deserted street running to the east and the west. Old boarded up shops line the street on both sides.

>n
fooAs you touch the plywood over the door, it transforms into a swarm a beetles and crawls off
Abandoned Shop
A simple wooden table with the word "AMISSIO" carved on it.

>s
Endless Street
You are standing on a deserted street running to the east and the west. Old boarded up shops line the street on both sides.

>n
fooAs you touch the plywood over the door, it transforms into a swarm a centipedes and crawls off
Abandoned Shop
A simple wooden table with the word "CARCER" carved on it.

* * *

>n
The shops are all boarded up.

>put quarter in meter
Clunk. The meter now indicates 15 minutes remaining.

>wake up
As far as you know, you're already awake.

>g
Reality is stranger.

Abandoned Living Room
A dirty living room in a long abandoned house. The windows have been boarded up. The only furniture that remains is a single ratty easy chair with a missing leg. A thin layer of dirt, broken glass, and pigeon shit covers the warped floorboards. To the northwest is a short hallway.

>n
You can't go that way.

[From here, you can go northwest and south.]

>nw
Bottom of Stairs
You are standing in a short hallway at the bottom of a stairway that climbs eastward into the darkness. To the southeast is the living room and to the north is what was most likely the remnants of a dining room. The door that formerly closed off this stairway has been removed from its hinges and cut in two. It now leans against the walls.

>e
Top of Stairs
You are standing in a short hallway at the top of the stairs. Bedrooms lie to the north, southeast and southwest. Each of the bedroom doors have been removed from their hinges, cut and half and leaned against the walls.

>u
You can't go that way.

[From here, you can go north, southeast, southwest, west and down.]

>se
Bedroom
This bedroom is completely empty. The roof is partially missing and parts of the floor have rotted away. On the other side of the room is a sealed up closet.

>nw
Top of Stairs
You are standing in a short hallway at the top of the stairs. Bedrooms lie to the north, southeast and southwest. Each of the bedroom doors have been removed from their hinges, cut and half and leaned against the walls.

>d
Bottom of Stairs
You are standing in a short hallway at the bottom of a stairway that climbs eastward into the darkness. To the southeast is the living room and to the north is what was most likely the remnants of a dining room. The door that formerly closed off this stairway has been removed from its hinges and cut in two. It now leans against the walls.

>s
You can't go that way.

[From here, you can go north, southeast, east and up.]

* * *

XXX
The Parking Meter
An Interactive Fiction by autowitch
Release 1 / Serial number 131202 / Inform 7 build 6G60 (I6/v6.32 lib 6/12N) SD

Endless Street
You are standing on a deserted street running to the east and the west. Old boarded up shops line the street on both sides.

You can see an a parking meter next to the street here.

>x car
You don't have a car. You came here by bus.

>x sky
It's grey and sullen.

>x buildings
Squat brick buildings line the street. All of which have been long boarded up. No signs remain to let you know what these places were.

>x windows
The windows are all boarded up.

* * *

>x car
You don't have a car. You came here by bus.

>e
You walk down the street for a long time and find yourself back where you started.
That's odd.

>w
You walk down the street for a long time and find yourself back where you started.

* * *

>z
You wait for hours, but no bus comes by to pick you up.

>x bus
You came here by the number 15 bus. It's been a long time since you've seen another once come by. Or anyone else for that matter.

I beg your pardon?

>n
The shops are all boarded up.

>e
You walk down the street for a long time and find yourself back where you started.

* * *

>w
You walk down the street for a long time and find yourself back where you started.

>s
The shops are all boarded up.

>z
You wait for hours, but no bus comes by to pick you up.

>x sky
It's grey and sullen.

>x street
An empty potholed street

>x buildings
Squat brick buildings line the street. All of which have been long boarded up. No signs remain to let you know what these places were.

>open window
You can't see any such thing.

>open windows
That's not something you can open.

* * *

XXX
The Parking Meter
An Interactive Fiction by autowitch
Release 1 / Serial number 131202 / Inform 7 build 6G60 (I6/v6.32 lib 6/12N) SD

Endless Street
You are standing on a deserted street running to the east and the west. Old boarded up shops line the street on both sides.

You can see an a parking meter next to the street here.

>x doars
You can't see any such thing.

>x doors
The doors are all boarded up.

>x graffiti
Oddly enough, there is no graffiti here. If there was graffiti here, it would probably warn you to stay away.

>x rats
Rats! Where?

>x street
An empty potholed street

* * *

>x potholes
Some of these potholes could swallow a Geo Metro.

>x boards
You can't see any such thing.

>x plywood
The amount of plywood used to board up these shops probably kept some lumber yard in business.

>x lumber yard
It doesn't matter which lumber yard.

I beg your pardon?

>x car
You don't have a car. You came here by bus.

* * *

XXX
The Parking Meter
An Interactive Fiction by autowitch
Release 1 / Serial number 131202 / Inform 7 build 6G60 (I6/v6.32 lib 6/12N) SD

Endless Street
You are standing on a deserted street running to the east and the west. Old boarded up shops line the street on both sides.

You can see an a parking meter next to the street here.

>open doors
The doors are securely boarded up.

>open door
You can't see any such thing.

* * *

XXX
The Parking Meter
An Interactive Fiction by autowitch
Release 1 / Serial number 131202 / Inform 7 build 6G60 (I6/v6.32 lib 6/12N) SD

Endless Street
You are standing on a deserted street running to the east and the west. Old boarded up shops line the street on both sides.

You can see an a parking meter next to the street here.

>take meter
That's fixed in place.

>move meter
It is fixed in place.

>eat meter
(first taking the parking meter)
That's fixed in place.

* * *

XXX
The Parking Meter
An Interactive Fiction by autowitch
Release 1 / Serial number 131202 / Inform 7 build 6G60 (I6/v6.32 lib 6/12N) SD

Endless Street
You are standing on a deserted street running to the east and the west. Old boarded up shops line the street on both sides.

You can see an a parking meter next to the street here.

>eat meter
You give it a good lick. It tastes like dirt and desperation.

>x rats
Rats! Where?

* * *

XXX
The Parking Meter
An Interactive Fiction by autowitch
Release 1 / Serial number 131202 / Inform 7 build 6G60 (I6/v6.32 lib 6/12N) SD

Endless Street
You are standing on a deserted street running to the east and the west. Old boarded up shops line the street on both sides.

You can see an a parking meter next to the street here.

>x garbage
The typical bits of paper and broken bottles that accumulate along deserted streets.

>x car
You don't have a car. You came here by bus.

>look at my car
You don't have a car. You came here by bus.

* * *

XXX
The Parking Meter
An Interactive Fiction by autowitch
Release 1 / Serial number 131202 / Inform 7 build 6G60 (I6/v6.32 lib 6/12N) SD

Endless Street
You are standing on a deserted street running to the east and the west. Old boarded up shops line the street on both sides.

You can see an a parking meter next to the street here.

>x my car
You don't have a car. You came here by bus.

* * *

XXX
The Parking Meter
An Interactive Fiction by autowitch
Release 1 / Serial number 131202 / Inform 7 build 6G60 (I6/v6.32 lib 6/12N) SD

Endless Street
You are standing on a deserted street running to the east and the west. Old boarded up shops line the street on both sides.

You can see an a parking meter next to the street here.

>enter my car
You don't have a car. You arrived here by bus.

>leave
But you aren't in anything at the moment.

* * *

XXX
The Parking Meter
An Interactive Fiction by autowitch
Release 1 / Serial number 131202 / Inform 7 build 6G60 (I6/v6.32 lib 6/12N) SD

Endless Street
You are standing on a deserted street running to the east and the west. Old boarded up shops line the street on both sides.

You can see an a parking meter next to the street here.

>enter
You must supply a noun.

>enter shops
They are well boarded up.

* * *

>enter
You must supply a noun.

>in
The shops are all boarded up.
You knock at one of the boarded up doors. There is no answer

>out
But you aren't in anything at the moment.

* * *

XXX
The Parking Meter
An Interactive Fiction by autowitch
Release 1 / Serial number 131202 / Inform 7 build 6G60 (I6/v6.32 lib 6/12N) SD

Endless Street
You are standing on a deserted street running to the east and the west. Old boarded up shops line the street on both sides.

You can see an a parking meter next to the street here.

>enter shops
They are well boarded up.

>enter shop
You can't see any such thing.

* * *

XXX
The Parking Meter
An Interactive Fiction by autowitch
Release 1 / Serial number 131202 / Inform 7 build 6G60 (I6/v6.32 lib 6/12N) SD

Endless Street
You are standing on a deserted street running to the east and the west. Old boarded up shops line the street on both sides.

You can see an a parking meter next to the street here.

>enter shop
They are well boarded up.

>exit
But you aren't in anything at the moment.

>x boards
The amount of plywood used to board up these shops probably kept some lumber yard in business.

>x lumber yard
It doesn't matter which lumber yard.

>x my car
You don't have a car. You came here by bus.

>enter my car
You don't have a car. You arrived here by bus.

>wait
You wait for hours, but no bus comes by to pick you up.

>z
You wait for hours, but no bus comes by to pick you up.

>help
That's not a verb I recognise.

>x meter
A new looking parking meter. There dial indicates that the time is expired.

* * *

XXX
The Parking Meter
An Interactive Fiction by autowitch
Release 1 / Serial number 131202 / Inform 7 build 6G60 (I6/v6.32 lib 6/12N) SD

Endless Street
You are standing on a deserted street running to the east and the west. Old boarded up shops line the street on both sides.

You can see an a parking meter next to the street here.

I beg your pardon?

>in
The shops are all boarded up.

>in
The shops are all boarded up.

>in
The shops are all boarded up.
 You try to peel some of the plywood off, but to no avail.

* * *

XXX
The Parking Meter
An Interactive Fiction by autowitch
Release 1 / Serial number 131202 / Inform 7 build 6G60 (I6/v6.32 lib 6/12N) SD

Endless Street
You are standing on a deserted street running to the east and the west. Old boarded up shops line the street on both sides.

You can see an a parking meter next to the street here.

>in
The shops are all boarded up. You knock at one of the boarded up doors. There is no answer

>n
The shops are all boarded up. You knock at one of the boarded up doors. You just hear a hollow noise.

>in
The shops are all boarded up. You try to peel some of the plywood off, but to no avail.

>in
The shops are all boarded up.

* * *

>in
The shops are all boarded up. You knock at one of the boarded up doors. There is no answer

>put coin in meter
Clunk. The meter now indicates 15 minutes remaining.

* * *

>in
The shops are all boarded up. You knock at one of the boarded up doors. There is no answer

>s
The shops are all boarded up. You try to peel some of the plywood off, but to no avail.

>put coin in meter
Clunk. The meter now indicates 15 minutes remaining.

>n
bar
You can't go that way.

>s
bar
You can't go that way.

* * *

XXX
The Parking Meter
An Interactive Fiction by autowitch
Release 1 / Serial number 131202 / Inform 7 build 6G60 (I6/v6.32 lib 6/12N) SD

Endless Street
You are standing on a deserted street running to the east and the west. Old boarded up shops line the street on both sides.

You can see an a parking meter next to the street here.

>i
You are carrying:
  a 1976 bicentennial quarter

>x quarter
foo

* * *

XXX
The Parking Meter
An Interactive Fiction by autowitch
Release 1 / Serial number 131202 / Inform 7 build 6G60 (I6/v6.32 lib 6/12N) SD

Endless Street
You are standing on a deserted street running to the east and the west. Old boarded up shops line the street on both sides.

You can see an a parking meter next to the street here.

>insert quarter
I didn't understand that sentence.

>insert quarter into meter
FOo
Endless Street
You are standing on a deserted street running to the east and the west. Old boarded up shops line the street on both sides.

* * *

XXX
The Parking Meter
An Interactive Fiction by autowitch
Release 1 / Serial number 131202 / Inform 7 build 6G60 (I6/v6.32 lib 6/12N) SD

Endless Street
You are standing on a deserted street running to the east and the west. Old boarded up shops line the street on both sides.

You can see an a parking meter next to the street here.

>put quarter
I didn't understand that sentence.

>insert quarter
I didn't understand that sentence.

>put quarter in meter
FOo

* * *

XXX
The Parking Meter
An Interactive Fiction by autowitch
Release 1 / Serial number 131202 / Inform 7 build 6G60 (I6/v6.32 lib 6/12N) SD

Endless Street
You are standing on a deserted street running to the east and the west. Old boarded up shops line the street on both sides.

You can see an a parking meter next to the street here.

>put quarter in meter
Clunk. The meter now indicates 15 minutes remaining.

* * *

>g
Reality is stranger.

Abandoned Living Room
A dirty living room in a long abandoned house. The windows have been boarded up. The only furniture that remains is a single ratty easy chair with a missing leg. A thin layer of dirt, broken glass, and pigeon shit covers the warped floorboards. To the northwest is a short hallway.

>g
Reality is stranger.

Abandoned Living Room
A dirty living room in a long abandoned house. The windows have been boarded up. The only furniture that remains is a single ratty easy chair with a missing leg. A thin layer of dirt, broken glass, and pigeon shit covers the warped floorboards. To the northwest is a short hallway.

>nw
Foo
Bottom of Stairs
You are standing in a short hallway at the bottom of a stairway that climbs eastward into the darkness. To the southeast is the living room and to the north is what was most likely the remnants of a dining room. The door that formerly closed off this stairway has been removed from its hinges and cut in two. It now leans against the walls.

* * *

>g
Reality is stranger.

Abandoned Living Room
A dirty living room in a long abandoned house. The windows have been boarded up. The only furniture that remains is a single ratty easy chair with a missing leg. A thin layer of dirt, broken glass, and pigeon shit covers the warped floorboards. To the northwest is a short hallway.

>nw
Bottom of Stairs
You are standing in a short hallway at the bottom of a stairway that climbs eastward into the darkness. To the southeast is the living room and to the north is what was most likely the remnants of a dining room. The door that formerly closed off this stairway has been removed from its hinges and cut in two. It now leans against the walls.

>u
Foo
Top of Stairs
You are standing in a short hallway at the top of the stairs. Bedrooms lie to the north, southeast and southwest. Each of the bedroom doors have been removed from their hinges, cut and half and leaned against the walls.

>se
Foo
Bedroom
This bedroom is completely empty. The roof is partially missing and parts of the floor have rotted away. On the other side of the room is a sealed up closet.

* * *

>put quarter in meter
Clunk. The meter now indicates 15 minutes remaining.

>l
Endless Street
You are standing on a deserted street running to the east and the west. Old boarded up shops line the street on both sides.

>x doors
[I didn't recognise all of the words in that command.]

>x
[What do you want to examine?]

>x shops
[You can't see the boarded up shops any more.]

>ne
As you touch the plywood over the door, it reduces to a swarm of moths and flies up and over the building.

Abandoned Shop
A simple wooden table with the word "RUBEUS" carved on it.

On the Wooden table is a left doll leg.

>wake up
As far as you know, you're already awake.

>wake up
Reality is stranger.

Abandoned Living Room
A dirty living room in a long abandoned house. The windows have been boarded up. The only furniture that remains is a single ratty easy chair with a missing leg. A thin layer of dirt, broken glass, and pigeon shit covers the warped floorboards. To the northwest is a short hallway.

>LOOK
Abandoned Living Room
A dirty living room in a long abandoned house. The windows have been boarded up. The only furniture that remains is a single ratty easy chair with a missing leg. A thin layer of dirt, broken glass, and pigeon shit covers the warped floorboards. To the northwest is a short hallway.

>nw
Bottom of Stairs
You are standing in a short hallway at the bottom of a stairway that climbs eastward into the darkness. To the southeast is the living room and to the north is what was most likely the remnants of a dining room. The door that formerly closed off this stairway has been removed from its hinges and cut in two. It now leans against the walls.

>u
Top of Stairs
You are standing in a short hallway at the top of the stairs. Bedrooms lie to the north, southeast and southwest. Each of the bedroom doors have been removed from their hinges, cut and half and leaned against the walls.

>d
Bottom of Stairs
You are standing in a short hallway at the bottom of a stairway that climbs eastward into the darkness. To the southeast is the living room and to the north is what was most likely the remnants of a dining room. The door that formerly closed off this stairway has been removed from its hinges and cut in two. It now leans against the walls.

>n
Dining Room
A smallish dining room. The wainscotting on the ceiling has weathered in to strings of wood dipping down from the ceiling. An outside door leads west, and interior doors lead south, southeast, and northeast.

You can see a bathroom door and a kitchen door here.

>x door
[Which do you mean, the 1) bathroom door or the 2) kitchen door?]

>1
(the bathroom door)
You see nothing unexpected about the bathroom door.

>open bathroom door
The door has already been removed from its hinges. There is no need to try to open it.

>LOOK
Dining Room
A smallish dining room. The wainscotting on the ceiling has weathered in to strings of wood dipping down from the ceiling. An outside door leads west, and interior doors lead south, southeast, and northeast.

You can see a bathroom door and a kitchen door here.

>wake up
Reality is stranger.

Laying on the street

* * *

XXX
The Parking Meter
An Interactive Fiction by autowitch
Release 1 / Serial number 131202 / Inform 7 build 6G60 (I6/v6.32 lib 6/12N) SD

Endless Street
You are standing on a deserted street running to the east and the west. Old boarded up shops line the street on both sides.

You can see an a parking meter next to the street here.

>put coin in meter
Clunk. The meter now indicates 15 minutes remaining.

* * *

>n
fooAs you touch the plywood over the door, it transforms into a swarm a moths and flies off
Abandoned Shop
A simple wooden table with the word "RUBEUS" carved on it.

On the Wooden table are a left doll leg, a right doll leg, a left doll arm, a right doll arm, a doll torso and a doll head.

>l
Abandoned Shop
A simple wooden table with the word "RUBEUS" carved on it.

On the Wooden table are a left doll leg, a right doll leg, a left doll arm, a right doll arm, a doll torso and a doll head.

* * *

>s
Endless Street
You are standing on a deserted street running to the east and the west. Old boarded up shops line the street on both sides.

>s
foo 1As you touch the plywood over the door, it transforms into a swarm a beetles and crawls off
Abandoned Shop
A simple wooden table with the word "AMISSIO" carved on it.

>n
Endless Street
You are standing on a deserted street running to the east and the west. Old boarded up shops line the street on both sides.

>n
foo 0
*** Run-time problem P10: Since the north is not allowed the property "connected_shops", it is against the rules to try to use it.

As you touch the plywood over the door, it transforms into a swarm a moths and flies off
Abandoned Shop
A simple wooden table with the word "RUBEUS" carved on it.

On the Wooden table are a left doll leg, a right doll leg, a left doll arm, a right doll arm, a doll torso and a doll head.

I beg your pardon?

>s
Endless Street
You are standing on a deserted street running to the east and the west. Old boarded up shops line the street on both sides.

>s
foo 0
*** Run-time problem P10: Since the south is not allowed the property "connected_shops", it is against the rules to try to use it.

As you touch the plywood over the door, it transforms into a swarm a moths and flies off
Abandoned Shop
A simple wooden table with the word "RUBEUS" carved on it.

On the Wooden table are a left doll leg, a right doll leg, a left doll arm, a right doll arm, a doll torso and a doll head.

>n
Endless Street
You are standing on a deserted street running to the east and the west. Old boarded up shops line the street on both sides.

>ne
foo 2As you touch the plywood over the door, it transforms into a swarm a centipedes and crawls off
Abandoned Shop
A simple wooden table with the word "CARCER" carved on it.

>s
You can't go that way.

>sw
Endless Street
You are standing on a deserted street running to the east and the west. Old boarded up shops line the street on both sides.

>n
foo 3As you touch the plywood over the door, it transforms into a swarm a spiders and crawls off
Abandoned Shop
A simple wooden table with the word "TRISITIA" carved on it.

>s
Endless Street
You are standing on a deserted street running to the east and the west. Old boarded up shops line the street on both sides.

>s
foo 4As you touch the plywood over the door, it transforms into a swarm a cockroaches and crawls off
Abandoned Shop
A simple wooden table.

I beg your pardon?

>s
You can't go that way.

>n
Endless Street
You are standing on a deserted street running to the east and the west. Old boarded up shops line the street on both sides.

>s
foo 5As you touch the plywood over the door, it transforms into a swarm a hornets and flies off
Abandoned Shop
A simple wooden table with the word "CAUDA DRACONIS" carved on it.

>n
Endless Street
You are standing on a deserted street running to the east and the west. Old boarded up shops line the street on both sides.

>s
foo 6

I beg your pardon?

* * *

>put coin in meter
Clunk. The meter now indicates 15 minutes remaining.

>wake up
As far as you know, you're already awake.

* * *

>g
Reality is stranger.

Abandoned Living Room
A dirty living room in a long abandoned house. The windows have been boarded up. The only furniture that remains is a single ratty easy chair with a missing leg. A thin layer of dirt, broken glass, and pigeon shit covers the warped floorboards. To the northwest is a short hallway.

>g
Reality is stranger.

Atrium

>g
Reality is stranger.

Laying on the street

>g
Reality is stranger.

Top of Seven Falls
This

>l
Interior of a coffin
A room barely large enough for you to lay down inside of. All sides are cushioned with dirty rotting fabric. Everything smells of earthy decay.

>LOOK
Interior of a coffin
A room barely large enough for you to lay down inside of. All sides are cushioned with dirty rotting fabric. Everything smells of earthy decay.

>die
[I'm sorry if you're feeling frustrated. If you like, you can type SAVE to store your progress to a file (in most interpreters), then RESTORE to come back to it later. In the meantime, you might try searching the web to see if there are hints available.]

>kill self
You give up the ghost as it were.

[Attacking yourself would have no effect, or that's not the way to do so.]

>x self
You see nothing unexpected about yourself.

>l
Interior of a coffin
A room barely large enough for you to lay down inside of. All sides are cushioned with dirty rotting fabric. Everything smells of earthy decay.

* * *

>g
Reality is stranger.

Top of Seven Falls
This

>die
You give up the ghost as it were.

Interior of a coffin
(as a ghost)
A room barely large enough for you to lay down inside of. All sides are cushioned with dirty rotting fabric. Everything smells of earthy decay.

A creepy skeleton fills up most of the space in here.

>take skeleton
You are not substantial enough to pick up anything.

>up
You pass through the earth above you.

Basement stairwell
(as a ghost)
A dusty, poorly lit stairwell. Steps go up from here. A door to the south probably further down. To the east is a dim hallway.

You can see Elevator room door and Hallway B East door here.

>s
(first opening Elevator room door)
You are a ghost and there's not much you can do to affect the physical world.

It seems to be locked.

>LOOK
Basement stairwell
(as a ghost)
A dusty, poorly lit stairwell. Steps go up from here. A door to the south probably further down. To the east is a dim hallway.

You can see Elevator room door and Hallway B East door here.

>x elevator room door
You are a ghost and there's not much you can do to affect the physical world.

You see nothing unexpected about Elevator room door.

* * *

>g
Reality is stranger.

Top of Seven Falls
This

>g
Reality is stranger.

Basement stairwell
A dusty, poorly lit stairwell. Steps go up from here. A door to the south probably further down. To the east is a dim hallway.

You can see metal door and Hallway B East door here.

>g
Reality is stranger.

Darkness
It is pitch dark, and you can't see a thing.

>g
You are frozen by the terrible visage of Mictlantecuhtli

>g
You are frozen by the terrible visage of Mictlantecuhtli

>n
You are frozen by the terrible visage of Mictlantecuhtli

>e
You are frozen by the terrible visage of MictlantecuhtliMictlantecuhtli takes a shard of glass and quickly runs it through your heart. You barely have time to notice the blood.

Darkness
It is pitch dark, and you can't see a thing.

>die
You give up the ghost as it were.

Interior of a coffin
(as a ghost)
A room barely large enough for you to lay down inside of. All sides are cushioned with dirty rotting fabric. Everything smells of earthy decay.

A creepy skeleton fills up most of the space in here.

>u
You pass through the earth above you.

Basement stairwell
(as a ghost)
A dusty, poorly lit stairwell. Steps go up from here. A door to the south probably further down. To the east is a dim hallway.

You can see Elevator room door and Hallway B East door here.

>s
>>> the south

* * *

>g
Reality is stranger.

Darkness
It is pitch dark, and you can't see a thing.

>x skeleton
[That's not something you can see now, or I misunderstood you.]

>wake up
Reality is stranger.

Darkness
It is pitch dark, and you can't see a thing.

>die
You give up the ghost and become one.

Interior of a coffin (as a ghost)
A room barely large enough for you to lay down inside of. All sides are cushioned with dirty rotting fabric. Everything smells of earthy decay.

A creepy skeleton fills up most of the space in here.

>eat skeleton
[You can't consume the creepy skeleton, or that's not the way to do so.]

* * *

>g
Reality is stranger.

Top of Seven Falls
This

>z
You are frozen by the terrible visage of Mictlantecuhtli

>z
You are frozen by the terrible visage of Mictlantecuhtli

>z
You are frozen by the terrible visage of MictlantecuhtliMictlantecuhtli takes a shard of glass and quickly runs it through your heart. You barely have time to notice the blood.

Laying on the street

>g
Time passes.

>wake up
Reality is stranger.

Darkness
It is pitch dark, and you can't see a thing.

>g
Reality is stranger.

Darkness
It is pitch dark, and you can't see a thing.

>g
Reality is stranger.

Darkness
It is pitch dark, and you can't see a thing.

>g
Reality is stranger.

Basement stairwell
A dusty, poorly lit stairwell. Steps go up from here. A door to the south probably further down. To the east is a dim hallway.

You can see Elevator room door and Hallway B East door here.

>s
(first opening Elevator room door)
It seems to be locked.

>w
You can't go that way.

[From here, you can go south and east.]

>e
Narrow Hallway
A claustrophobic little hallway. To the west is a door leading to a stairwell. To the east is a heavy metal door labeled "Maintenance". Apartments B1, B2 and B3 are to the northeast, northwest and south respectively.

You can see a maintenance room door, Apartment B2 door, Apartment B1 door and Hallway B East door here.

>ne
(first opening Apartment B1 door)

Apartment B1
You can see Apartment B1 door here.

>sw
You can't go that way.

[The only way to go is south.]

>s
Narrow Hallway
A claustrophobic little hallway. To the west is a door leading to a stairwell. To the east is a heavy metal door labeled "Maintenance". Apartments B1, B2 and B3 are to the northeast, northwest and south respectively.

You can see Apartment B1 door, Hallway B East door, a maintenance room door and Apartment B2 door here.

>s
You can't go that way.

[From here, you can go northeast, northwest, east and west.]

>LOOK
Narrow Hallway
A claustrophobic little hallway. To the west is a door leading to a stairwell. To the east is a heavy metal door labeled "Maintenance". Apartments B1, B2 and B3 are to the northeast, northwest and south respectively.

You can see Apartment B1 door, Hallway B East door, a maintenance room door and Apartment B2 door here.

>wake up
Reality is stranger.

Darkness
It is pitch dark, and you can't see a thing.

>die
You give up the ghost and become one.

Interior of a coffin
(as a ghost)
A room barely large enough for you to lay down inside of. All sides are cushioned with dirty rotting fabric. Everything smells of earthy decay.

A creepy skeleton fills up most of the space in here.

>u
You pass through the earth above you.

Basement stairwell
(as a ghost)
A dusty, poorly lit stairwell. Steps go up from here. A door to the south probably further down. To the east is a dim hallway.

You can see Elevator room door and Hallway B East door here.

>s
Your spirit passes through the closed door.

Elevator room
(as a ghost)
You can enter the elevator here.

You can also see Elevator room door here.

>enter
[You must supply a noun.]

>enter elevator
[Which do you mean, the 1) underground elevator exterior or 2) Elevator room door?]

>1
(the underground elevator exterior)
Lift
(as a ghost)
A dingy elevator that starts in the basement and only goes down from there. One of the florescent lights keeps flickering. A dimly illuminated number above the door says -1 - though you can make it move by pressing a numbered button.

>push button
[That's not something you can see now, or I misunderstood you.]

>push -2
You are a ghost and there's not much you can do to affect the physical world.

>LOOK
Lift
(as a ghost)
A dingy elevator that starts in the basement and only goes down from there. One of the florescent lights keeps flickering. A dimly illuminated number above the door says -1 - though you can make it move by pressing a numbered button.

>z
Time passes.

>z
Time passes.

>out
You are a ghost and there's not much you can do to affect the physical world.

>exit
You are a ghost and there's not much you can do to affect the physical world.

>l
Lift
(as a ghost)
A dingy elevator that starts in the basement and only goes down from there. One of the florescent lights keeps flickering. A dimly illuminated number above the door says -1 - though you can make it move by pressing a numbered button.

>x button
[That's not something you can see now, or I misunderstood you.]

>x buttons
[I didn't recognise all of the words in that command.]

>push 1
You are a ghost and there's not much you can do to affect the physical world.

>push 99
You are a ghost and there's not much you can do to affect the physical world.

>w
You can't go that way.

[The only way to go is outside.]

>outside
Elevator room
(as a ghost)
You can enter the elevator here.

You can also see Elevator room door here.

You feel oddly revitalized.

>x door
You see nothing unexpected about Elevator room door.

>enter
[You must supply a noun.]

* * *

>enter elevator
[Which do you mean, the 1) underground elevator exterior or 2) Elevator room door?]

>2
(first opening Elevator room door)
It seems to be locked.

>enter elevator
[Which do you mean, the 1) underground elevator exterior or 2) Elevator room door?]

>1
(the underground elevator exterior)
Lift
A dingy elevator that starts in the basement and only goes down from there. One of the florescent lights keeps flickering. A dimly illuminated number above the door says -1 - though you can make it move by pressing a numbered button.

>push -10
You press button -10. The lift whirs into action and moves to the correct level.

>out
Level -10
You can enter the elevator here.

>in
Lift
A dingy elevator that starts in the basement and only goes down from there. One of the florescent lights keeps flickering. A dimly illuminated number above the door says -10 - though you can make it move by pressing a numbered button.

>push -7
You press button -7. The lift whirs into action and moves to the correct level.

>out
Level -7
You can enter the elevator here.

* * *

>g
Reality is stranger.

Laying on the street

>die
You give up the ghost as it were.

Interior of a coffin
(as a ghost)
A room barely large enough for you to lay down inside of. All sides are cushioned with dirty rotting fabric. Everything smells of earthy decay.

A creepy skeleton fills up most of the space in here.

>up
You pass through the earth above you.

Basement stairwell
(as a ghost)
A dusty, poorly lit stairwell. Steps go up from here. A door to the south probably further down. To the east is a dim hallway.

You can see Elevator room door and Hallway B East door here.

You can't go that way.

[From here, you can go south and east.]

* * *

>g
Reality is stranger.

Atrium

>die
You give up the ghost and become one.

Interior of a coffin (as a ghost)
A room barely large enough for you to lay down inside of. All sides are cushioned with dirty rotting fabric. Everything smells of earthy decay.

A creepy skeleton fills up most of the space in here.

>take skeleton
You are not substantial enough to pick up anything.

* * *

>die
You give up the ghost and become one.

Interior of a coffin (as a ghost)
A room barely large enough for you to lay down inside of. All sides are cushioned with dirty rotting fabric. Everything smells of earthy decay.

A creepy skeleton fills up most of the space in here.

>u
You pass through the earth above you.

Basement stairwell
(as a ghost)
A dusty, poorly lit stairwell. Steps go up from here. A door to the south probably further down. To the east is a dim hallway.

You can see Elevator room door and Hallway B East door here.

>s
>>> the south>>> Elevator room
(first opening Elevator room door)
You are a ghost and there's not much you can do to affect the physical world.

>w
You can't go that way.

[From here, you can go south and east.]

>e
Narrow Hallway
(as a ghost)
A claustrophobic little hallway. To the west is a door leading to a stairwell. To the east is a heavy metal door labeled "Maintenance". Apartments B1, B2 and B3 are to the northeast, northwest and south respectively.

You can see a maintenance room door, Apartment B2 door, Apartment B1 door and Hallway B East door here.

>ne
(first opening Apartment B1 door)
You are a ghost and there's not much you can do to affect the physical world.

* * *

>die
You give up the ghost and become one.

Interior of a coffin (as a ghost)
A room barely large enough for you to lay down inside of. All sides are cushioned with dirty rotting fabric. Everything smells of earthy decay.

A creepy skeleton fills up most of the space in here.

>l
Interior of a coffin (as a ghost)
A room barely large enough for you to lay down inside of. All sides are cushioned with dirty rotting fabric. Everything smells of earthy decay.

A creepy skeleton fills up most of the space in here.

>x skeleton
The skeleton belongs to someone who has been dead for a long time - presumably yourself. The clothing is partially rotted away and only little bits of semi-mummified skin and viscera remain of your former soft parts.

>eat it
[You can't consume the creepy skeleton, or that's not the way to do so.]

* * *

>g
Reality is stranger.

Atrium

>e
It is pitch dark, and you can't see a thing.

>n
It is pitch dark, and you can't see a thing.

>d
It is pitch dark, and you can't see a thing.

>u
It is pitch dark, and you can't see a thing.

>out
[You're not inside something. To leave this location, try a direction or "out".]

>exit
[You're not inside something. To leave this location, try a direction or "out".]

>die
You give up the ghost as it were.

Interior of a coffin
(as a ghost)
A room barely large enough for you to lay down inside of. All sides are cushioned with dirty rotting fabric. Everything smells of earthy decay.

A creepy skeleton fills up most of the space in here.

>take coffin
[That's not something you can see now, or I misunderstood you.]

>take skeleton
You are not substantial enough to pick up anything.

>exit
You can't go that way.

[In fact, you can't see any obvious exits.]

You are a ghost and there's not much you can do to affect the physical world.

[You're not inside something. To leave this location, try a direction or "out".]

>out
You pass through the earth above you.

Basement stairwell
(as a ghost)
A dusty, poorly lit stairwell. Steps go up from here. A door to the south probably further down. To the east is a dim hallway.

You can see Elevator room door and Hallway B East door here.

You can't go that way.

[From here, you can go south and east.]

You are a ghost and there's not much you can do to affect the physical world.

[** Programming error: tried to "move" yourself to nothing **]
You get out of Interior of a coffin.

Basement stairwell
(as a ghost)
A dusty, poorly lit stairwell. Steps go up from here. A door to the south probably further down. To the east is a dim hallway.

You can see Elevator room door and Hallway B East door here.

>LOOK
Basement stairwell
(as a ghost)
A dusty, poorly lit stairwell. Steps go up from here. A door to the south probably further down. To the east is a dim hallway.

You can see Elevator room door and Hallway B East door here.

>e
Narrow Hallway
(as a ghost)
A claustrophobic little hallway. To the west is a door leading to a stairwell. To the east is a heavy metal door labeled "Maintenance". Apartments B1, B2 and B3 are to the northeast, northwest and south respectively.

You can see a maintenance room door, Apartment B2 door, Apartment B1 door and Hallway B East door here.

>s
You can't go that way.

[From here, you can go northeast, northwest, east and west.]

>ne
(first opening Apartment B1 door)
You are a ghost and there's not much you can do to affect the physical world.

Apartment B1
(as a ghost)
You can see Apartment B1 door here.

>se
You can't go that way.

[The only way to go is south.]

>s
Narrow Hallway
(as a ghost)
A claustrophobic little hallway. To the west is a door leading to a stairwell. To the east is a heavy metal door labeled "Maintenance". Apartments B1, B2 and B3 are to the northeast, northwest and south respectively.

You can see Apartment B1 door, Hallway B East door, a maintenance room door and Apartment B2 door here.

>e
(first opening the maintenance room door)
You are a ghost and there's not much you can do to affect the physical world.

It seems to be locked.

>e
(first opening the maintenance room door)
You are a ghost and there's not much you can do to affect the physical world.

It seems to be locked.

You feel oddly revitalized.

>e
(first opening the maintenance room door)
It seems to be locked.

>LOOK
Narrow Hallway
A claustrophobic little hallway. To the west is a door leading to a stairwell. To the east is a heavy metal door labeled "Maintenance". Apartments B1, B2 and B3 are to the northeast, northwest and south respectively.

You can see Apartment B1 door, Hallway B East door, a maintenance room door and Apartment B2 door here.

>wake up
Reality is stranger.

Top of Seven Falls
This

>g
Reality is stranger.

Laying on the street

>g
Reality is stranger.

Interior of a coffin
A room barely large enough for you to lay down inside of. All sides are cushioned with dirty rotting fabric. Everything smells of earthy decay.

A creepy skeleton fills up most of the space in here.

* * *

>g
Reality is stranger.

Abandoned Living Room
A dirty living room in a long abandoned house. The windows have been boarded up. The only furniture that remains is a single ratty easy chair with a missing leg. A thin layer of dirt, broken glass, and pigeon shit covers the warped floorboards. To the northwest is a short hallway.

>die
You give up the ghost and become one.

Interior of a coffin
(as a ghost)
A room barely large enough for you to lay down inside of. All sides are cushioned with dirty rotting fabric. Everything smells of earthy decay.

A creepy skeleton fills up most of the space in here.

>u
You pass through the earth above you.

Basement stairwell
(as a ghost)
A dusty, poorly lit stairwell. Steps go up from here. A door to the south probably further down. To the east is a dim hallway.

You can see metal door and Hallway B East door here.

>w
You can't go that way.

[From here, you can go south and east.]

>e
Narrow Hallway
(as a ghost)
A claustrophobic little hallway. To the west is a door leading to a stairwell. To the east is a heavy metal door labeled "Maintenance". Apartments B1, B2 and B3 are to the northeast, northwest and south respectively.

You can see a maintenance room door, Apartment B3 door, Apartment B2 door, Apartment B1 door and Hallway B East door here.

>s
Your spirit passes through the closed door.

Apartment B3
(as a ghost)
You can see Apartment B3 door here.

>n
Your spirit passes through the closed door.

Narrow Hallway
(as a ghost)
A claustrophobic little hallway. To the west is a door leading to a stairwell. To the east is a heavy metal door labeled "Maintenance". Apartments B1, B2 and B3 are to the northeast, northwest and south respectively.

You can see Apartment B3 door, Apartment B2 door, Apartment B1 door, Hallway B East door and a maintenance room door here.

>e
Your spirit passes through the closed door.

maintenance room
(as a ghost)
You can see a maintenance room door here.

>w
Your spirit passes through the closed door.

Narrow Hallway
(as a ghost)
A claustrophobic little hallway. To the west is a door leading to a stairwell. To the east is a heavy metal door labeled "Maintenance". Apartments B1, B2 and B3 are to the northeast, northwest and south respectively.

You can see a maintenance room door, Apartment B3 door, Apartment B2 door, Apartment B1 door and Hallway B East door here.

>w
Basement stairwell
(as a ghost)
A dusty, poorly lit stairwell. Steps go up from here. A door to the south probably further down. To the east is a dim hallway.

You can see Hallway B East door and metal door here.

>s
Your spirit passes through the closed door.

Basement lobby
(as a ghost)
You can enter the elevator here.

You can also see metal door here.

>i
You are a ghost and there's not much you can do to affect the physical world.

>enter
[You must supply a noun.]

>enter elevator
Lift
(as a ghost)
A dingy elevator that starts in the basement and only goes down from there. One of the florescent lights keeps flickering. A dimly illuminated number above the door says -1 - though you can make it move by pressing a numbered button.

>push -
[I only understood the first part of that-- trying anyway.]
>PUSH
[What do you want to push?]

>-2
You are a ghost and there's not much you can do to affect the physical world.

>x elevator
[That's not something you can see now, or I misunderstood you.]

>out
You are a ghost and there's not much you can do to affect the physical world.

>outside
Basement lobby
(as a ghost)
You can enter the elevator here.

You can also see metal door here.

You feel oddly revitalized.

>enter
[You must supply a noun.]

>enter elevator
Lift
A dingy elevator that starts in the basement and only goes down from there. One of the florescent lights keeps flickering. A dimly illuminated number above the door says -1 - though you can make it move by pressing a numbered button.

>push -10
You press button -10. The lift whirs into action and moves to the correct level.

>exit
Computer room annex
You can enter the elevator here.

* * *

>put coin in meter
Clunk. The meter now indicates 15 minutes remaining.

>LOOK
Endless Street
You are standing on a deserted street running to the east and the west. Old boarded up shops line the street on both sides.

>wake up
As far as you know, you're already awake.

* * *

>g
Reality is stranger.

Abandoned Living Room
A dirty living room in a long abandoned house. The windows have been boarded up. The only furniture that remains is a single ratty easy chair with a missing leg. A thin layer of dirt, broken glass, and pigeon shit covers the warped floorboards. To the northwest is a short hallway.

>g
Reality is stranger.

Darkness
It is pitch dark, and you can't see a thing.

>die
You give up the ghost as it were.

Interior of a coffin
(as a ghost)
A room barely large enough for you to lay down inside of. All sides are cushioned with dirty rotting fabric. Everything smells of earthy decay.

A creepy skeleton fills up most of the space in here.

* * *

>u
You pass through the earth above you.

Basement stairwell
(as a ghost)
A dusty, poorly lit stairwell. Steps go up from here. A door to the south probably further down. To the east is a dim hallway.

You can see Elevator room door and Hallway B East door here.

>s
Your spirit passes through the closed door.

Elevator room
(as a ghost)
You can see Elevator room door here.

>n
Your spirit passes through the closed door.

Basement stairwell
(as a ghost)
A dusty, poorly lit stairwell. Steps go up from here. A door to the south probably further down. To the east is a dim hallway.

You can see Elevator room door and Hallway B East door here.

>w
You can't go that way.

[From here, you can go south and east.]

* * *

>e
Narrow Hallway
(as a ghost)
A claustrophobic little hallway. To the west is a door leading to a stairwell. To the east is a heavy metal door labeled "Maintenance". Apartments B1, B2 and B3 are to the northeast, northwest and south respectively.

You can see a maintenance room door, Apartment B2 door, Apartment B1 door and Hallway B East door here.

>e
Your spirit passes through the closed door.

maintenance room
(as a ghost)
You can see a maintenance room door here.

>z
You are a ghost and there's not much you can do to affect the physical world.

>LOOK
maintenance room
(as a ghost)
You can see a maintenance room door here.

>look
maintenance room
(as a ghost)
You can see a maintenance room door here.

>g
maintenance room
(as a ghost)
You can see a maintenance room door here.

>g
maintenance room
(as a ghost)
You can see a maintenance room door here.

>g
maintenance room
(as a ghost)
You can see a maintenance room door here.

You feel oddly revitalized.

>e
You can't go that way.

[The only way to go is west.]

>w
(first opening the maintenance room door)
It seems to be locked.

>unlock door
(with the maintenance room door)
(first taking the maintenance room door)
[The maintenance room door isn't portable.]

* * *

XXX
The Parking Meter
An Interactive Fiction by autowitch
Release 1 / Serial number 131202 / Inform 7 build 6G60 (I6/v6.32 lib 6/12N) SD

Endless Street
You are standing on a deserted street running to the east and the west. Old boarded up shops line the street on both sides.

You can see an a parking meter next to the street here.

>showme pothole
>SHOWME POTHOLES
potholes - thing
location: in Endless Street
singular-named, improper-named; unlit, inedible, fixed in place, scenery, neuter, ordinarily enumerated, seen, unfamiliar, unknown
printed name: "potholes"
printed plural name: none
indefinite article: none
description: "Some of these potholes could swallow a Geo Metro."
initial appearance: none
disambiguation id: 0

* * *

XXX
The Parking Meter
An Interactive Fiction by autowitch
Release 1 / Serial number 131202 / Inform 7 build 6G60 (I6/v6.32 lib 6/12N) SD

Endless Street
You are standing on a deserted street running to the east and the west. Old boarded up shops line the street on both sides.

You can see an a parking meter next to the street here.

>showme potholes
potholes - thing
location: in Endless Street
singular-named, improper-named; unlit, inedible, fixed in place, scenery, neuter, ordinarily enumerated, seen, unfamiliar, unknown
printed name: "potholes"
printed plural name: none
indefinite article: none
description: "Some of these potholes could swallow a Geo Metro."
initial appearance: none
disambiguation id: 0

>showverb
Try typing "showverb" and then the name of a verb.

* * *

>showme potholes
potholes - thing
location: in Endless Street
singular-named, improper-named; unlit, inedible, fixed in place, scenery, neuter, ordinarily enumerated, seen, unfamiliar, unknown
printed name: "potholes"
printed plural name: none
indefinite article: none
description: "Some of these potholes could swallow a Geo Metro."
initial appearance: none
disambiguation id: 0

>x potholes
x
Some of these potholes could swallow a Geo Metro.

* * *

XXX
The Parking Meter
An Interactive Fiction by autowitch
Release 1 / Serial number 131202 / Inform 7 build 6G60 (I6/v6.32 lib 6/12N) SD

Endless Street
You are standing on a deserted street running to the east and the west. Old boarded up shops line the street on both sides.

You can see an a parking meter next to the street here.

>x potholes
"t" = thing: potholes
x
Some of these potholes could swallow a Geo Metro.

>showme potholes
potholes - thing
location: in Endless Street
singular-named, improper-named; unlit, inedible, fixed in place, scenery, neuter, ordinarily enumerated, seen, familiar, unknown
printed name: "potholes"
printed plural name: none
indefinite article: none
description: "Some of these potholes could swallow a Geo Metro."
initial appearance: none
disambiguation id: 0

* * *

>x potholes
"t" = thing: potholes
x
Some of these potholes could swallow a Geo Metro.

>showverb x
Verb 'check' 'describe' 'examine' 'inspect' 'observe' 'view' 'watch' 'x'
     * noun -> Examine
     * scope=Routine(26339) -> A84_overly_elaborate_looking
     * scope=Routine(26352) -> A84_overly_elaborate_looking
     * scope=Routine(26365) -> A87_remembering
     * scope=Routine(26378) -> A87_remembering

* * *

XXX
The Parking Meter
An Interactive Fiction by autowitch
Release 1 / Serial number 131202 / Inform 7 build 6G60 (I6/v6.32 lib 6/12N) SD

Endless Street
You are standing on a deserted street running to the east and the west. Old boarded up shops line the street on both sides.

You can see an a parking meter next to the street here.

>die
[I'm sorry if you're feeling frustrated. If you like, you can type SAVE to store your progress to a file (in most interpreters), then RESTORE to come back to it later. In the meantime, you might try searching the web to see if there are hints available.
]

>kill self
[Attacking yourself would have no effect, or that's not the way to do so.]

* * *

>die
[I'm sorry if you're feeling frustrated. If you like, you can type SAVE to store your progress to a file (in most interpreters), then RESTORE to come back to it later. In the meantime, you might try searching the web to see if there are hints available.
]

>put quarter in meter
Clunk. The meter now indicates 15 minutes remaining.

* * *

>g
Reality is stranger.

Abandoned Living Room
A dirty living room in a long abandoned house. The windows have been boarded up. The only furniture that remains is a single ratty easy chair with a missing leg. A thin layer of dirt, broken glass, and pigeon shit covers the warped floorboards. To the northwest is a short hallway.

>die
[I'm sorry if you're feeling frustrated. If you like, you can type SAVE to store your progress to a file (in most interpreters), then RESTORE to come back to it later. In the meantime, you might try searching the web to see if there are hints available.
]

>wake up
Reality is stranger.

Top of Seven Falls
This

* * *

>g
Reality is stranger.

Laying on the street

>g
Reality is stranger.

Darkness
It is pitch dark, and you can't see a thing.

* * *

>die
You give up the ghost as it were.

Interior of a coffin
(as a ghost)
A room barely large enough for you to lay down inside of. All sides are cushioned with dirty rotting fabric. Everything smells of earthy decay.

A creepy skeleton fills up most of the space in here.

>x skeleton
The skeleton belongs to someone who has been dead for a long time - presumably yourself. The clothing is partially rotted away and only little bits of semi-mummified skin and viscera remain of your former soft parts.

>d
You can't go that way.

[In fact, you can't see any obvious exits.]

>LOOK
Interior of a coffin
(as a ghost)
A room barely large enough for you to lay down inside of. All sides are cushioned with dirty rotting fabric. Everything smells of earthy decay.

A creepy skeleton fills up most of the space in here.

>i
You are carrying nothing.

>take skeleton
Taken.

>i
You are carrying:
  a creepy skeleton

>drop skeleton
Dropped.

* * *

XXX
The Parking Meter
An Interactive Fiction by autowitch
Release 1 / Serial number 131202 / Inform 7 build 6G60 (I6/v6.32 lib 6/12N) SD

Endless Street
You are standing on a deserted street running to the east and the west. Old boarded up shops line the street on both sides.

You can see an a parking meter next to the street here.

>kill self
[Attacking yourself would have no effect, or that's not the way to do so.]

>put coin in meter
Clunk. The meter now indicates 15 minutes remaining.

* * *

>wake up
As far as you know, you're already awake.

>g
Reality is stranger.

Laying on the street

* * *

>g
Reality is stranger.

Top of Seven Falls
This

>g
Reality is stranger.

Abandoned Living Room
A dirty living room in a long abandoned house. The windows have been boarded up. The only furniture that remains is a single ratty easy chair with a missing leg. A thin layer of dirt, broken glass, and pigeon shit covers the warped floorboards. To the northwest is a short hallway.

>g
Reality is stranger.

Top of Seven Falls
This

* * *

>kill self
[Attacking yourself would have no effect, or that's not the way to do so.]

>kill myself
[I'm sorry if you're feeling frustrated. If you like, you can type SAVE to store your progress to a file (in most interpreters), then RESTORE to come back to it later. In the meantime, you might try searching the web to see if there are hints available.
]

>put coin in meter
Clunk. The meter now indicates 15 minutes remaining.

* * *

>g
Reality is stranger.

Darkness
It is pitch dark, and you can't see a thing.

>l
Darkness
It is pitch dark, and you can't see a thing.

>x self
It is pitch dark, and you can't see a thing.

>die
You give up the ghost as it were.

>x self
It is pitch dark, and you can't see a thing.

* * *

XXX
The Parking Meter
An Interactive Fiction by autowitch
Release 1 / Serial number 131202 / Inform 7 build 6G60 (I6/v6.32 lib 6/12N) SD

Endless Street
You are standing on a deserted street running to the east and the west. Old boarded up shops line the street on both sides.

You can see an a parking meter next to the street here.

>how do i play?
>HOW DO I PLAY
[Try typing LOOK for a description of your surroundings. Any compass directions indicate exits which you can use by typing (for example) NORTH or N. Some of the objects mentioned in the description might be worth a closer look with a command like EXAMINE WINDOWS. You can also TAKE or DROP some things, type INVENTORY to see a list of what you're carrying already, OPEN or CLOSE containers or doors, and so on.]

* * *

XXX
The Parking Meter
An Interactive Fiction by autowitch
Release 1 / Serial number 131202 / Inform 7 build 6G60 (I6/v6.32 lib 6/12N) SD

Endless Street
You are standing on a deserted street running to the east and the west. Old boarded up shops line the street on both sides.

You can see an a parking meter next to the street here.

>push button
[That's not something you can see now, or I misunderstood you.]

>put coin in meter
Clunk. The meter now indicates 15 minutes remaining.

* * *

>nw
Bottom of Stairs
You are standing in a short hallway at the bottom of a stairway that climbs eastward into the darkness. To the southeast is the living room and to the north is what was most likely the remnants of a dining room. The door that formerly closed off this stairway has been removed from its hinges and cut in two. It now leans against the walls.

>n
Dining Room
A smallish dining room. The wainscotting on the ceiling has weathered in to strings of wood dipping down from the ceiling. An outside door leads west, and interior doors lead south, southeast, and northeast.

You can see a bathroom door and a kitchen door here.

* * *

>1
(the bathroom door)
You see nothing unexpected about the bathroom door.

>LOOK
Dining Room
A smallish dining room. The wainscotting on the ceiling has weathered in to strings of wood dipping down from the ceiling. An outside door leads west, and interior doors lead south, southeast, and northeast.

You can see a bathroom door and a kitchen door here.

* * *

>wake up
Reality is stranger.

Laying on the street

>g
Reality is stranger.

Basement stairwell
A dusty, poorly lit stairwell. Steps go up from here. A door to the south probably further down. To the east is a dim hallway.

You can see metal door and Hallway B East door here.

>e
Narrow Hallway
A claustrophobic little hallway. To the west is a door leading to a stairwell. To the east is a heavy metal door labeled "Maintenance". Apartments B1, B2 and B3 are to the northeast, northwest and south respectively.

You can see a maintenance room door, Apartment B3 door, Apartment B2 door, Apartment B1 door and Hallway B East door here.

>LOOK
Narrow Hallway
A claustrophobic little hallway. To the west is a door leading to a stairwell. To the east is a heavy metal door labeled "Maintenance". Apartments B1, B2 and B3 are to the northeast, northwest and south respectively.

You can see a maintenance room door, Apartment B3 door, Apartment B2 door, Apartment B1 door and Hallway B East door here.

>e
(first opening the maintenance room door)
It seems to be locked.

>ne
(first opening Apartment B1 door)

Apartment B1
You can see Apartment B1 door here.

>l
Apartment B1
You can see Apartment B1 door here.